1011111111111111111111111
1000000000100000000000001
1111111110101111101111111
1010000010101000001000001
1010101110101111111011101
1000100010101000100010001
1111111010101010101110101
1000100010101010100010101
1010101110101010111010101
1010001000101010000010101
1011111011101011111110101
1000000010000010000010101
1011111110111110111010101
1000000010100000101000101
1111111011101111101111101
1000001000101000001000101
1011111110101011101110101
1000000010101000100000101
1011111010101110111111101
1010001010001000100000001
1011101011111011101111111
1000101000001000001000001
1110101011111011111111101
1000001000000000000000000
1111111111111111111111111