11111111111111111111111111111111111111111111111111
10000000000000000000000000000000000000000000000001
11111111111111011111111111111111111111111111111001
10000000000001000000000000000000000000000000001001
10111111111011111111111111111111111111111111001001
10000000001000000000000000000000000000000001001001
10111111011111111111111111111111111111111001001001
10000001000000000000000000000000000000001001001001
11111011111111111111111111111111111111001001001001
10001000000000000000000000000000000001001001001001
10101111111111111111111111111111111001001001001001
10000000000000000000000000000000001001001001001001
10111111111111111111111111111111101001001001001001
10000000000000000000000000000000101001001001001001
11111111111111111111111111111110101001001001001001
10000000000000000000000000000000101001001001001001
10111111111111111111111111111111101001001001001001
10000000000000000000000000000000001001001001001001
11111111111111111111111111111111111001001001001001
10000000000000000000000000000000000001001001001001
10111111111111111111111111111111111111001001001001
10000000000000000000000000000000000000001001001001
10111111111111111111111111111111111111111001001001
10000000000000000000000000000000000000000001001001
10111111111111111111111111111111111111111111001001
10000000000000000000000000000000000000000000001001
10111111111111111111111111111111111111111111111001
10000000000000000000000000000000000000000000000000
11111111111111111111111111111111111111111111111111